NO ./path_to_the_north_texture
F 220,100,0
EA ./path_to_the_east_texture
SO ./path_to_the_south_texture
C 225,30,0




WE ./path_to_the_west_texture




111111111111111
100000000000001
110000000000001
111000000000001
111111111111111
