NO ./assets/NO_wall.png
F 220,100,0
C 91,60,17
EA ./assets/EA_wall.png
SO ./assets/SO_wall.png
WE ./assets/WE_wall.png




11111111
1S100001
10100001
10100001
10000001
10000101
10000001
11111111
