NO ./assets/NO_wall.png
C 227,177,210
EA ./assets/EA_wall.png
SO ./assets/SO_wall.png
F 119,181,254
WE ./assets/WE_wall.png





  1111   1111
 100001 100001
100000010000001
100000000000001
100000000000001
100000000000001
 1000000000001
  10000000001
   100000001
    1000001
     10001
      1S1
       1
